[
  {
    "model": "game.level",
    "pk": 1,
    "fields": {
      "number": 1,
      "name_uz": "Toshkent hovlisi",
      "description_uz": "O'z hovlingizni yashil va toza qiling. Daraxt turing, gullar oching, chiqindilarni tozalang. Bu eng birinchi qadamingiz!",
      "required_score": 0,
      "map_config": {
        "iso_width": 10,
        "iso_height": 8,
        "initial_resources": 100,
        "regen_rate": 0.2,
        "ground": [
          3,3,3,3,3,3,3,3,3,3,
          3,4,4,4,4,4,4,4,4,3,
          3,4,0,0,0,0,0,4,4,3,
          3,4,0,0,0,0,0,0,4,3,
          3,4,0,0,0,0,0,0,4,3,
          3,4,0,0,0,0,0,4,4,3,
          3,4,4,4,4,4,4,4,4,3,
          3,3,3,3,3,3,3,3,3,3
        ],
        "pollution": [
          20,20,20,20,20,20,20,20,20,20,
          20,60,60,60,60,60,60,60,60,20,
          20,60,15,15,15,15,15,60,60,20,
          20,60,15,15,15,15,15,15,60,20,
          20,60,15,15,15,15,15,15,60,20,
          20,60,15,15,15,15,15,60,60,20,
          20,60,60,60,60,60,60,60,60,20,
          20,20,20,20,20,20,20,20,20,20
        ]
      },
      "ecosystem_initial": {"air": 30, "water": 25, "soil": 20, "biodiversity": 15}
    }
  },
  {
    "model": "game.level",
    "pk": 2,
    "fields": {
      "number": 2,
      "name_uz": "Chorsu bozori atrofi",
      "description_uz": "Chorsu atrofidagi mahallani ekologik toza qiling. Ko'proq daraxt o'tqazing, ariqlarni tozalang, qo'shnilaringizga namuna bo'ling!",
      "required_score": 500,
      "map_config": {
        "iso_width": 15,
        "iso_height": 12,
        "initial_resources": 80,
        "regen_rate": 0.3,
        "ground": [
          3,3,3,3,3,3,3,3,3,3,3,3,3,3,3,
          3,4,4,4,4,4,4,4,4,4,4,4,4,4,3,
          3,4,0,0,4,0,0,0,4,0,0,4,0,4,3,
          3,4,0,0,4,0,0,0,4,0,0,4,0,4,3,
          3,4,4,4,4,4,4,4,4,4,4,4,4,4,3,
          3,2,2,4,0,0,0,0,0,0,4,2,2,2,3,
          3,2,2,4,0,0,0,0,0,0,4,2,2,2,3,
          3,4,4,4,4,4,4,4,4,4,4,4,4,4,3,
          3,4,0,0,0,4,0,0,4,0,0,0,0,4,3,
          3,4,0,0,0,4,0,0,4,0,0,0,0,4,3,
          3,4,4,4,4,4,4,4,4,4,4,4,4,4,3,
          3,3,3,3,3,3,3,3,3,3,3,3,3,3,3
        ],
        "pollution": [
          20,20,20,20,20,20,20,20,20,20,20,20,20,20,20,
          20,55,55,55,55,55,55,55,55,55,55,55,55,55,20,
          20,55,10,10,55,10,10,10,55,10,10,55,10,55,20,
          20,55,10,10,55,10,10,10,55,10,10,55,10,55,20,
          20,55,55,55,55,55,55,55,55,55,55,55,55,55,20,
          20, 5, 5,55,10,10,10,10,10,10,55, 5, 5, 5,20,
          20, 5, 5,55,10,10,10,10,10,10,55, 5, 5, 5,20,
          20,55,55,55,55,55,55,55,55,55,55,55,55,55,20,
          20,55,10,10,10,55,10,10,55,10,10,10,10,55,20,
          20,55,10,10,10,55,10,10,55,10,10,10,10,55,20,
          20,55,55,55,55,55,55,55,55,55,55,55,55,55,20,
          20,20,20,20,20,20,20,20,20,20,20,20,20,20,20
        ]
      },
      "ecosystem_initial": {"air": 25, "water": 20, "soil": 15, "biodiversity": 10}
    }
  },
  {
    "model": "game.level",
    "pk": 3,
    "fields": {
      "number": 3,
      "name_uz": "Toshkent shahri",
      "description_uz": "Shahar ekologiyasini yaxshilang. Sanoat korxonalari ifloslanishiga qarshi kurashing. Bu juda muhim vazifa!",
      "required_score": 1500,
      "map_config": {
        "iso_width": 20,
        "iso_height": 15,
        "initial_resources": 60,
        "regen_rate": 0.4,
        "ground": [
          3,3,3,3,3,3,3,3,3,3,3,3,3,3,3,3,3,3,3,3,
          3,4,4,4,4,4,4,4,4,4,4,4,4,4,4,4,4,4,4,3,
          3,4,0,0,4,0,0,4,4,4,4,0,0,4,0,0,0,0,4,3,
          3,4,0,0,4,0,0,4,2,2,4,0,0,4,0,0,0,0,4,3,
          3,4,4,4,4,4,4,4,2,2,4,4,4,4,4,4,4,4,4,3,
          3,4,0,0,0,0,4,4,2,2,4,4,0,0,0,0,0,0,4,3,
          3,4,0,0,0,0,4,0,0,0,0,4,0,0,0,0,0,0,4,3,
          3,4,4,4,4,4,4,0,0,0,0,4,4,4,4,4,4,4,4,3,
          3,4,0,4,0,0,4,0,4,4,0,4,0,4,0,0,0,0,4,3,
          3,4,0,4,0,0,4,0,4,4,0,4,0,4,0,0,0,0,4,3,
          3,4,4,4,4,4,4,4,4,4,4,4,4,4,4,4,4,4,4,3,
          3,4,0,0,0,4,0,0,0,4,0,0,0,4,0,0,0,4,4,3,
          3,4,0,0,0,4,0,0,0,4,0,0,0,4,0,0,0,4,4,3,
          3,4,4,4,4,4,4,4,4,4,4,4,4,4,4,4,4,4,4,3,
          3,3,3,3,3,3,3,3,3,3,3,3,3,3,3,3,3,3,3,3
        ],
        "pollution": [
          25,25,25,25,25,25,25,25,25,25,25,25,25,25,25,25,25,25,25,25,
          25,65,65,65,65,65,65,65,65,65,65,65,65,65,65,65,65,65,65,25,
          25,65,20,20,65,20,20,65,65,65,65,20,20,65,20,20,20,20,65,25,
          25,65,20,20,65,20,20,65, 5, 5,65,20,20,65,20,20,20,20,65,25,
          25,65,65,65,65,65,65,65, 5, 5,65,65,65,65,65,65,65,65,65,25,
          25,65,20,20,20,20,65,65, 5, 5,65,65,20,20,20,20,20,20,65,25,
          25,65,20,20,20,20,65,20,20,20,20,65,20,20,20,20,20,20,65,25,
          25,65,65,65,65,65,65,20,20,20,20,65,65,65,65,65,65,65,65,25,
          25,65,20,65,20,20,65,20,65,65,20,65,20,65,20,20,20,20,65,25,
          25,65,20,65,20,20,65,20,65,65,20,65,20,65,20,20,20,20,65,25,
          25,65,65,65,65,65,65,65,65,65,65,65,65,65,65,65,65,65,65,25,
          25,65,20,20,20,65,20,20,20,65,20,20,20,65,20,20,20,65,65,25,
          25,65,20,20,20,65,20,20,20,65,20,20,20,65,20,20,20,65,65,25,
          25,65,65,65,65,65,65,65,65,65,65,65,65,65,65,65,65,65,65,25,
          25,25,25,25,25,25,25,25,25,25,25,25,25,25,25,25,25,25,25,25
        ]
      },
      "ecosystem_initial": {"air": 15, "water": 15, "soil": 10, "biodiversity": 8}
    }
  },
  {
    "model": "game.level",
    "pk": 4,
    "fields": {
      "number": 4,
      "name_uz": "Chirchiq daryosi",
      "description_uz": "Chirchiq daryosi havzasini tiklang. Sanoat ifloslanishiga qarshi kurashing, daryoni toza saqlang. Siz qahramonsiz!",
      "required_score": 3000,
      "map_config": {
        "iso_width": 25,
        "iso_height": 18,
        "initial_resources": 50,
        "regen_rate": 0.5,
        "ground": [
          3,3,3,3,3,3,3,3,3,3,3,3,3,3,3,3,3,3,3,3,3,3,3,3,3,
          3,4,4,4,4,4,4,4,4,4,4,4,4,4,4,4,4,4,4,4,4,4,4,4,3,
          3,4,0,0,4,0,0,0,4,4,2,2,2,2,2,4,4,0,0,0,4,0,0,4,3,
          3,4,0,0,4,0,0,0,4,4,2,2,2,2,2,4,4,0,0,0,4,0,0,4,3,
          3,4,4,4,4,4,4,4,4,4,2,2,2,2,2,4,4,4,4,4,4,4,4,4,3,
          3,4,0,0,0,0,4,0,0,0,2,2,2,2,2,0,0,0,4,0,0,0,0,4,3,
          3,4,0,0,0,0,4,0,0,0,0,0,2,0,0,0,0,0,4,0,0,0,0,4,3,
          3,4,4,4,4,4,4,4,4,4,4,4,2,4,4,4,4,4,4,4,4,4,4,4,3,
          3,4,0,4,0,0,4,0,4,0,0,4,2,4,0,0,4,0,4,0,0,4,0,4,3,
          3,4,0,4,0,0,4,0,4,0,0,4,2,4,0,0,4,0,4,0,0,4,0,4,3,
          3,4,4,4,4,4,4,4,4,4,4,4,2,4,4,4,4,4,4,4,4,4,4,4,3,
          3,4,0,0,0,4,0,0,0,4,0,0,2,0,0,4,0,0,0,4,0,0,0,4,3,
          3,4,0,0,0,4,0,0,0,4,0,4,2,4,0,4,0,0,0,4,0,0,0,4,3,
          3,4,4,4,4,4,4,4,4,4,4,4,2,4,4,4,4,4,4,4,4,4,4,4,3,
          3,4,0,0,4,0,0,0,4,0,0,4,2,4,0,0,4,0,0,0,4,0,0,4,3,
          3,4,0,0,4,0,0,0,4,0,0,4,2,4,0,0,4,0,0,0,4,0,0,4,3,
          3,4,4,4,4,4,4,4,4,4,4,4,4,4,4,4,4,4,4,4,4,4,4,4,3,
          3,3,3,3,3,3,3,3,3,3,3,3,3,3,3,3,3,3,3,3,3,3,3,3,3
        ],
        "pollution": [
          30,30,30,30,30,30,30,30,30,30,30,30,30,30,30,30,30,30,30,30,30,30,30,30,30,
          30,70,70,70,70,70,70,70,70,70,70,70,70,70,70,70,70,70,70,70,70,70,70,70,30,
          30,70,25,25,70,25,25,25,70,70, 5, 5, 5, 5, 5,70,70,25,25,25,70,25,25,70,30,
          30,70,25,25,70,25,25,25,70,70, 5, 5, 5, 5, 5,70,70,25,25,25,70,25,25,70,30,
          30,70,70,70,70,70,70,70,70,70, 5, 5, 5, 5, 5,70,70,70,70,70,70,70,70,70,30,
          30,70,25,25,25,25,70,25,25,25, 5, 5, 5, 5, 5,25,25,25,70,25,25,25,25,70,30,
          30,70,25,25,25,25,70,25,25,25,25,25, 5,25,25,25,25,25,70,25,25,25,25,70,30,
          30,70,70,70,70,70,70,70,70,70,70,70, 5,70,70,70,70,70,70,70,70,70,70,70,30,
          30,70,25,70,25,25,70,25,70,25,25,70, 5,70,25,25,70,25,70,25,25,70,25,70,30,
          30,70,25,70,25,25,70,25,70,25,25,70, 5,70,25,25,70,25,70,25,25,70,25,70,30,
          30,70,70,70,70,70,70,70,70,70,70,70, 5,70,70,70,70,70,70,70,70,70,70,70,30,
          30,70,25,25,25,70,25,25,25,70,25,25, 5,25,25,70,25,25,25,70,25,25,25,70,30,
          30,70,25,25,25,70,25,25,25,70,25,70, 5,70,25,70,25,25,25,70,25,25,25,70,30,
          30,70,70,70,70,70,70,70,70,70,70,70, 5,70,70,70,70,70,70,70,70,70,70,70,30,
          30,70,25,25,70,25,25,25,70,25,25,70, 5,70,25,25,70,25,25,25,70,25,25,70,30,
          30,70,25,25,70,25,25,25,70,25,25,70, 5,70,25,25,70,25,25,25,70,25,25,70,30,
          30,70,70,70,70,70,70,70,70,70,70,70,70,70,70,70,70,70,70,70,70,70,70,70,30,
          30,30,30,30,30,30,30,30,30,30,30,30,30,30,30,30,30,30,30,30,30,30,30,30,30
        ]
      },
      "ecosystem_initial": {"air": 10, "water": 10, "soil": 8, "biodiversity": 5}
    }
  }
]
